/detail_project/<int:project_id>/audit-trail/	detail_project.views.audit_trail_view	detail_project:audit_trail
/detail_project/<int:project_id>/detail-ahsp-gabungan/	detail_project.views.rincian_ahsp_view	detail_project:detail_ahsp_gabungan_legacy
/detail_project/<int:project_id>/detail-ahsp/	detail_project.views.template_ahsp_view	detail_project:detail_ahsp_legacy
/detail_project/<int:project_id>/export-test/	detail_project.views.export_test_view	detail_project:export_test
/detail_project/<int:project_id>/harga-items/	detail_project.views.harga_items_view	detail_project:harga_items
/detail_project/<int:project_id>/jadwal-pekerjaan/	detail_project.views.jadwal_pekerjaan_view	detail_project:jadwal_pekerjaan
/detail_project/<int:project_id>/list-pekerjaan/	detail_project.views.list_pekerjaan_view	detail_project:list_pekerjaan
/detail_project/<int:project_id>/orphan-cleanup/	detail_project.views.orphan_cleanup_view	detail_project:orphan_cleanup
/detail_project/<int:project_id>/rekap-kebutuhan/	detail_project.views.rekap_kebutuhan_view	detail_project:rekap_kebutuhan
/detail_project/<int:project_id>/rekap-rab/	detail_project.views.rekap_rab_view	detail_project:rekap_rab
/detail_project/<int:project_id>/rincian-ahsp/	detail_project.views.rincian_ahsp_view	detail_project:rincian_ahsp
/detail_project/<int:project_id>/rincian-rab/	detail_project.views.rincian_rab_view	detail_project:rincian_rab
/detail_project/<int:project_id>/template-ahsp/	detail_project.views.template_ahsp_view	detail_project:template_ahsp
/detail_project/<int:project_id>/volume-pekerjaan/	detail_project.views.volume_pekerjaan_view	detail_project:volume_pekerjaan
/detail_project/api/export/download/<uuid:export_id>	detail_project.views_export.export_download	detail_project:export_download
/detail_project/api/export/finalize	detail_project.views_export.export_finalize	detail_project:export_finalize
/detail_project/api/export/init	detail_project.views_export.export_init	detail_project:export_init
/detail_project/api/export/status/<uuid:export_id>	detail_project.views_export.export_status	detail_project:export_status
/detail_project/api/export/upload-pages	detail_project.views_export.export_upload_pages	detail_project:export_upload_pages
/detail_project/api/monitoring/deprecation-metrics/	detail_project.views_monitoring.api_deprecation_metrics	detail_project:api_deprecation_metrics
/detail_project/api/monitoring/deprecation-metrics/reset/	detail_project.views_monitoring.api_reset_deprecation_metrics	detail_project:api_reset_deprecation_metrics
/detail_project/api/monitoring/performance-metrics/	detail_project.views_monitoring.api_performance_metrics	detail_project:api_performance_metrics
/detail_project/api/monitoring/performance-metrics/reset/	detail_project.views_monitoring.api_reset_performance_metrics	detail_project:api_reset_performance_metrics
/detail_project/api/monitoring/report-client-metric/	detail_project.views_monitoring.api_report_client_metric	detail_project:api_report_client_metric
/detail_project/api/project/<int:project_id>/audit-trail/	detail_project.views_api.api_get_audit_trail	detail_project:api_get_audit_trail
/detail_project/api/project/<int:project_id>/batch-copy/	detail_project.views_api.api_batch_copy_project	detail_project:api_batch_copy_project
/detail_project/api/project/<int:project_id>/change-status/	detail_project.views_api.api_get_change_status	detail_project:api_get_change_status
/detail_project/api/project/<int:project_id>/conversion-profile/save/	detail_project.views_api.api_save_conversion_profile	detail_project:api_save_conversion_profile
/detail_project/api/project/<int:project_id>/conversion-profiles/	detail_project.views_api.api_get_conversion_profiles	detail_project:api_get_conversion_profiles
/detail_project/api/project/<int:project_id>/deep-copy/	detail_project.views_api.api_deep_copy_project	detail_project:api_deep_copy_project
/detail_project/api/project/<int:project_id>/detail-ahsp/<int:pekerjaan_id>/	detail_project.views_api.api_get_detail_ahsp	detail_project:api_get_detail_ahsp
/detail_project/api/project/<int:project_id>/detail-ahsp/<int:pekerjaan_id>/reset-to-ref/	detail_project.views_api.api_reset_detail_ahsp_to_ref	detail_project:api_reset_detail_ahsp_to_ref
/detail_project/api/project/<int:project_id>/detail-ahsp/<int:pekerjaan_id>/save/	detail_project.views_api.api_save_detail_ahsp_for_pekerjaan	detail_project:api_save_detail_ahsp_for_pekerjaan
/detail_project/api/project/<int:project_id>/detail-ahsp/save/	detail_project.views_api.api_save_detail_ahsp_gabungan	detail_project:api_save_detail_ahsp_gabungan
/detail_project/api/project/<int:project_id>/export/full-backup/json/	detail_project.views_api.export_project_full_json	detail_project:export_project_full_json
/detail_project/api/project/<int:project_id>/export/harga-items/csv/	detail_project.views_api.export_harga_items_csv	detail_project:export_harga_items_csv
/detail_project/api/project/<int:project_id>/export/harga-items/json/	detail_project.views_api.export_harga_items_json	detail_project:export_harga_items_json
/detail_project/api/project/<int:project_id>/export/harga-items/pdf/	detail_project.views_api.export_harga_items_pdf	detail_project:export_harga_items_pdf
/detail_project/api/project/<int:project_id>/export/harga-items/pdf/	detail_project.views_api.export_harga_items_pdf	detail_project:export_harga_items_pdf
/detail_project/api/project/<int:project_id>/export/harga-items/word/	detail_project.views_api.export_harga_items_word	detail_project:export_harga_items_word
/detail_project/api/project/<int:project_id>/export/harga-items/word/	detail_project.views_api.export_harga_items_word	detail_project:export_harga_items_word
/detail_project/api/project/<int:project_id>/export/harga-items/xlsx/	detail_project.views_api.export_harga_items_xlsx	detail_project:export_harga_items_xlsx
/detail_project/api/project/<int:project_id>/export/jadwal-pekerjaan/csv/	detail_project.views_api.export_jadwal_pekerjaan_csv	detail_project:export_jadwal_pekerjaan_csv
/detail_project/api/project/<int:project_id>/export/jadwal-pekerjaan/pdf/	detail_project.views_api.export_jadwal_pekerjaan_pdf	detail_project:export_jadwal_pekerjaan_pdf
/detail_project/api/project/<int:project_id>/export/jadwal-pekerjaan/professional/	detail_project.views_api.export_jadwal_pekerjaan_professional	detail_project:export_jadwal_pekerjaan_professional
/detail_project/api/project/<int:project_id>/export/jadwal-pekerjaan/word/	detail_project.views_api.export_jadwal_pekerjaan_word	detail_project:export_jadwal_pekerjaan_word
/detail_project/api/project/<int:project_id>/export/jadwal-pekerjaan/xlsx/	detail_project.views_api.export_jadwal_pekerjaan_xlsx	detail_project:export_jadwal_pekerjaan_xlsx
/detail_project/api/project/<int:project_id>/export/list-pekerjaan/json/	detail_project.views_api.export_list_pekerjaan_json	detail_project:export_list_pekerjaan_json
/detail_project/api/project/<int:project_id>/export/rekap-kebutuhan/json/	detail_project.views_api.export_rekap_kebutuhan_json	detail_project:api_export_rekap_kebutuhan_json
/detail_project/api/project/<int:project_id>/export/rekap-kebutuhan/pdf/	detail_project.views_api.export_rekap_kebutuhan_pdf	detail_project:api_export_rekap_kebutuhan_pdf
/detail_project/api/project/<int:project_id>/export/rekap-kebutuhan/word/	detail_project.views_api.export_rekap_kebutuhan_word	detail_project:api_export_rekap_kebutuhan_word
/detail_project/api/project/<int:project_id>/export/rekap-kebutuhan/xlsx/	detail_project.views_api.export_rekap_kebutuhan_xlsx	detail_project:api_export_rekap_kebutuhan_xlsx
/detail_project/api/project/<int:project_id>/export/rekap-rab/csv/	detail_project.views_api.export_rekap_rab_csv	detail_project:export_rekap_rab_csv
/detail_project/api/project/<int:project_id>/export/rekap-rab/json/	detail_project.views_api.export_rekap_rab_json	detail_project:export_rekap_rab_json
/detail_project/api/project/<int:project_id>/export/rekap-rab/pdf/	detail_project.views_api.export_rekap_rab_pdf	detail_project:export_rekap_rab_pdf
/detail_project/api/project/<int:project_id>/export/rekap-rab/word/	detail_project.views_api.export_rekap_rab_word	detail_project:export_rekap_rab_word
/detail_project/api/project/<int:project_id>/export/rekap-rab/xlsx/	detail_project.views_api.export_rekap_rab_xlsx	detail_project:export_rekap_rab_xlsx
/detail_project/api/project/<int:project_id>/export/rincian-ahsp/csv/	detail_project.views_api.export_rincian_ahsp_csv	detail_project:export_rincian_ahsp_csv
/detail_project/api/project/<int:project_id>/export/rincian-ahsp/pdf/	detail_project.views_api.export_rincian_ahsp_pdf	detail_project:export_rincian_ahsp_pdf
/detail_project/api/project/<int:project_id>/export/rincian-ahsp/word/	detail_project.views_api.export_rincian_ahsp_word	detail_project:export_rincian_ahsp_word
/detail_project/api/project/<int:project_id>/export/rincian-ahsp/xlsx/	detail_project.views_api.export_rincian_ahsp_xlsx	detail_project:export_rincian_ahsp_xlsx
/detail_project/api/project/<int:project_id>/export/template-ahsp/json/	detail_project.views_api.export_template_ahsp_json	detail_project:export_template_ahsp_json
/detail_project/api/project/<int:project_id>/export/volume-pekerjaan/json/	detail_project.views_api.export_volume_pekerjaan_json	detail_project:export_volume_pekerjaan_json
/detail_project/api/project/<int:project_id>/export/volume-pekerjaan/pdf/	detail_project.views_api.export_volume_pekerjaan_pdf	detail_project:export_volume_pekerjaan_pdf
/detail_project/api/project/<int:project_id>/export/volume-pekerjaan/word/	detail_project.views_api.export_volume_pekerjaan_word	detail_project:export_volume_pekerjaan_word
/detail_project/api/project/<int:project_id>/export/volume-pekerjaan/xlsx/	detail_project.views_api.export_volume_pekerjaan_xlsx	detail_project:export_volume_pekerjaan_xlsx
/detail_project/api/project/<int:project_id>/harga-items/list/	detail_project.views_api.api_list_harga_items	detail_project:api_list_harga_items
/detail_project/api/project/<int:project_id>/harga-items/save/	detail_project.views_api.api_save_harga_items	detail_project:api_save_harga_items
/detail_project/api/project/<int:project_id>/list-pekerjaan/save/	detail_project.views_api.api_save_list_pekerjaan	detail_project:api_save_list_pekerjaan
/detail_project/api/project/<int:project_id>/list-pekerjaan/tree/	detail_project.views_api.api_get_list_pekerjaan_tree	detail_project:api_get_list_pekerjaan_tree
/detail_project/api/project/<int:project_id>/list-pekerjaan/upsert/	detail_project.views_api.api_upsert_list_pekerjaan	detail_project:api_upsert_list_pekerjaan
/detail_project/api/project/<int:project_id>/orphaned-items/	detail_project.views_api.api_list_orphaned_harga_items	detail_project:api_list_orphaned_items
/detail_project/api/project/<int:project_id>/orphaned-items/cleanup/	detail_project.views_api.api_cleanup_orphaned_harga_items	detail_project:api_cleanup_orphaned_items
/detail_project/api/project/<int:project_id>/parameters/	detail_project.views_api.api_project_parameters	detail_project:api_project_parameters
/detail_project/api/project/<int:project_id>/parameters/<int:param_id>/	detail_project.views_api.api_project_parameter_detail	detail_project:api_project_parameter_detail
/detail_project/api/project/<int:project_id>/parameters/sync/	detail_project.views_api.api_project_parameters_sync	detail_project:api_project_parameters_sync
/detail_project/api/project/<int:project_id>/pekerjaan/<int:pekerjaan_id>/assignments/	detail_project.views_api_tahapan.api_get_pekerjaan_assignments	detail_project:api_get_pekerjaan_assignments
/detail_project/api/project/<int:project_id>/pekerjaan/<int:pekerjaan_id>/bundle/<int:bundle_id>/expansion/	detail_project.views_api.api_get_bundle_expansion	detail_project:api_get_bundle_expansion
/detail_project/api/project/<int:project_id>/pekerjaan/<int:pekerjaan_id>/pricing/	detail_project.views_api.api_pekerjaan_pricing	detail_project:api_pekerjaan_pricing
/detail_project/api/project/<int:project_id>/pricing/	detail_project.views_api.api_project_pricing	detail_project:api_project_pricing
/detail_project/api/project/<int:project_id>/regenerate-tahapan/	detail_project.views_api_tahapan.api_regenerate_tahapan	detail_project:api_regenerate_tahapan
/detail_project/api/project/<int:project_id>/rekap-kebutuhan-enhanced/	detail_project.views_api_tahapan.api_get_rekap_kebutuhan_enhanced	detail_project:api_get_rekap_kebutuhan_enhanced
/detail_project/api/project/<int:project_id>/rekap-kebutuhan-timeline/	detail_project.views_api_tahapan.api_get_rekap_kebutuhan_timeline	detail_project:api_get_rekap_kebutuhan_timeline
/detail_project/api/project/<int:project_id>/rekap-kebutuhan/	detail_project.views_api.api_get_rekap_kebutuhan	detail_project:api_get_rekap_kebutuhan
/detail_project/api/project/<int:project_id>/rekap-kebutuhan/filters/	detail_project.views_api_tahapan.api_get_rekap_kebutuhan_filters	detail_project:api_get_rekap_kebutuhan_filters
/detail_project/api/project/<int:project_id>/rekap-kebutuhan/validate/	detail_project.views_api.api_validate_rekap_kebutuhan	detail_project:api_validate_rekap_kebutuhan
/detail_project/api/project/<int:project_id>/rekap/	detail_project.views_api.api_get_rekap_rab	detail_project:api_get_rekap_rab
/detail_project/api/project/<int:project_id>/rincian-rab/	detail_project.views_api.api_get_rincian_rab	detail_project:api_get_rincian_rab
/detail_project/api/project/<int:project_id>/rincian-rab/export.csv	detail_project.views_api.api_export_rincian_rab_csv	detail_project:api_export_rincian_rab_csv
/detail_project/api/project/<int:project_id>/search-ahsp/	detail_project.views_api.api_search_ahsp	detail_project:api_search_ahsp
/detail_project/api/project/<int:project_id>/tahapan/	detail_project.views_api_tahapan.api_list_create_tahapan	detail_project:api_list_create_tahapan
/detail_project/api/project/<int:project_id>/tahapan/<int:tahapan_id>/	detail_project.views_api_tahapan.api_update_delete_tahapan	detail_project:api_update_delete_tahapan
/detail_project/api/project/<int:project_id>/tahapan/<int:tahapan_id>/assign/	detail_project.views_api_tahapan.api_assign_pekerjaan_to_tahapan	detail_project:api_assign_pekerjaan
/detail_project/api/project/<int:project_id>/tahapan/<int:tahapan_id>/unassign/	detail_project.views_api_tahapan.api_unassign_pekerjaan_from_tahapan	detail_project:api_unassign_pekerjaan
/detail_project/api/project/<int:project_id>/tahapan/reorder/	detail_project.views_api_tahapan.api_reorder_tahapan	detail_project:api_reorder_tahapan
/detail_project/api/project/<int:project_id>/tahapan/unassigned/	detail_project.views_api_tahapan.api_get_unassigned_pekerjaan	detail_project:api_unassigned_pekerjaan
/detail_project/api/project/<int:project_id>/tahapan/validate/	detail_project.views_api_tahapan.api_validate_all_assignments	detail_project:api_validate_assignments
/detail_project/api/project/<int:project_id>/templates/<int:template_id>/import/	detail_project.views_api.api_import_template	detail_project:api_import_template
/detail_project/api/project/<int:project_id>/templates/create/	detail_project.views_api.api_create_template	detail_project:api_create_template
/detail_project/api/project/<int:project_id>/templates/export/	detail_project.views_api.export_template_json	detail_project:export_template_json
/detail_project/api/project/<int:project_id>/templates/import-file/	detail_project.views_api.api_import_template_from_file	detail_project:api_import_template_from_file
/detail_project/api/project/<int:project_id>/volume-formula-state/	detail_project.views_api.api_volume_formula_state	detail_project:api_volume_formula_state_alias
/detail_project/api/project/<int:project_id>/volume-pekerjaan/list/	detail_project.views_api.api_list_volume_pekerjaan	detail_project:api_list_volume_pekerjaan
/detail_project/api/project/<int:project_id>/volume-pekerjaan/save/	detail_project.views_api.api_save_volume_pekerjaan	detail_project:api_save_volume_pekerjaan
/detail_project/api/project/<int:project_id>/volume/formula/	detail_project.views_api.api_volume_formula_state	detail_project:api_volume_formula_state
/detail_project/api/project/import/json/	detail_project.views_api.import_project_from_json	detail_project:import_project_from_json
/detail_project/api/templates/	detail_project.views_api.api_list_templates	detail_project:api_list_templates
/detail_project/api/templates/<int:template_id>/	detail_project.views_api.api_get_template_detail	detail_project:api_get_template_detail
/detail_project/api/templates/<int:template_id>/delete/	detail_project.views_api.api_delete_template	detail_project:api_delete_template
/detail_project/api/v2/project/<int:project_id>/assign-weekly/	detail_project.views_api_tahapan_v2.api_assign_pekerjaan_weekly	detail_project:api_v2_assign_weekly
/detail_project/api/v2/project/<int:project_id>/assignments/	detail_project.views_api_tahapan_v2.api_get_project_assignments_v2	detail_project:api_v2_get_project_assignments
/detail_project/api/v2/project/<int:project_id>/chart-data/	detail_project.views_api.api_chart_data	detail_project:api_chart_data
/detail_project/api/v2/project/<int:project_id>/kurva-s-data/	detail_project.views_api.api_kurva_s_data	detail_project:api_kurva_s_data
/detail_project/api/v2/project/<int:project_id>/kurva-s-harga/	detail_project.views_api.api_kurva_s_harga_data	detail_project:api_kurva_s_harga_data
/detail_project/api/v2/project/<int:project_id>/pekerjaan/<int:pekerjaan_id>/assignments/	detail_project.views_api_tahapan_v2.api_get_pekerjaan_assignments_v2	detail_project:api_v2_get_assignments
/detail_project/api/v2/project/<int:project_id>/pekerjaan/<int:pekerjaan_id>/weekly-progress/	detail_project.views_api_tahapan_v2.api_get_pekerjaan_weekly_progress	detail_project:api_v2_get_weekly_progress
/detail_project/api/v2/project/<int:project_id>/regenerate-tahapan/	detail_project.views_api_tahapan_v2.api_regenerate_tahapan_v2	detail_project:api_v2_regenerate_tahapan
/detail_project/api/v2/project/<int:project_id>/rekap-kebutuhan-weekly/	detail_project.views_api.api_rekap_kebutuhan_weekly	detail_project:api_rekap_kebutuhan_weekly
/detail_project/api/v2/project/<int:project_id>/reset-progress/	detail_project.views_api_tahapan_v2.api_reset_progress	detail_project:api_v2_reset_progress
/detail_project/api/v2/project/<int:project_id>/week-boundary/	detail_project.views_api_tahapan_v2.api_update_week_boundaries	detail_project:api_update_week_boundaries
/detail_project/monitoring/deprecation-dashboard/	detail_project.views_monitoring.api_deprecation_dashboard	detail_project:deprecation_dashboard
/detail_project/monitoring/performance-dashboard/	detail_project.views_monitoring.api_performance_dashboard	detail_project:performance_dashboard
/health/	detail_project.views_health.health_check	health_check
/health/live/	detail_project.views_health.liveness_check	liveness_check
/health/ready/	detail_project.views_health.readiness_check	readiness_check
/health/simple/	detail_project.views_health.health_check_simple	health_check_simple
